!Microsoft IME Dictionary Tool
!Version:
!Format:WORDLIST
!User Dictionary Name:
!Output File Name:
!DateTime:

みち	盈	一段動詞
みた	盈	動詞サ行五段
かけ	虧	一段動詞
えいき	盈虧	名詞
きえい	虧盈	名詞
1	一	名詞
2	二	名詞
3	三	名詞
4	四	名詞
5	五	名詞
6	六	名詞
7	七	名詞
8	八	名詞
9	九	名詞
きがく	気学	名詞
きがく	氣学	名詞
きゅうせい	九星	名詞
いっぱく	一白	名詞
じこく	二黒	名詞
さんぺき	三碧	名詞
しろく	四緑	名詞
ごおう	五黄	名詞
ろっぱく	六白	名詞
しちせき	七赤	名詞
はっぱく	八白	名詞
きゅうし	九紫	名詞
いっぱく	一白水星	名詞
じこく	二黒土星	名詞
さんぺき	三碧木星	名詞
しろく	四緑木星	名詞
ごおう	五黄土星	名詞
ろっぱく	六白金星	名詞
しちせき	七赤金星	名詞
はっぱく	八白土星	名詞
きゅうし	九紫火星	名詞
かと	河図	名詞
りくしょ	洛書	名詞
らくしょ	洛書	名詞
しゅうえき	周易	名詞
えききょう	易経	名詞
しょきょう	書経	名詞
しょうしょ	尚書	名詞
らいき	礼記	名詞
しきょう	詩経	名詞
こうていだいきょう	黄帝内経	名詞
せつもんかいじ	説文解字	名詞
せつもんかいじ	說文解字	名詞
こうきじてん	康熙字典	名詞
けん	☰	名詞
だ	☱	名詞
り	☲	名詞
しん	☳	名詞
そん	☴	名詞
かん	☵	名詞
ごん	☶	名詞
こん	☷	名詞
けん	乾	名詞
だ	兌	名詞
り	離	名詞
しん	震	名詞
そん	巽	名詞
かん	坎	名詞
ごん	艮	名詞
こん	坤	名詞
てん	☰	名詞
たく	☱	名詞
か	☲	名詞
らい	☳	名詞
ふう	☴	名詞
すい	☵	名詞
さん	☶	名詞
ち	☷	名詞
ちてんたい	地天泰	名詞
さんてんたいちく	山天大畜	名詞
すいてんじゅ	水天需	名詞
ふうてんしょうちく	風天小畜	名詞
らいてんたいそう	雷天大壮	名詞
かてんたいゆう	火天大有	名詞
たくてんかい	沢天夬	名詞
けんいてん	乾為天	名詞
ちたくりん	地沢臨	名詞
さんたくそん	山沢損	名詞
すいたくせつ	水沢節	名詞
ふうたくちゅうふ	風沢中孚	名詞
らいたくきまい	雷沢帰妹	名詞
かたくけい	火沢睽	名詞
だいたく	兌為沢	名詞
てんたくり	天沢履	名詞
ちかめいい	地火明夷	名詞
さんかひ	山火賁	名詞
すいかきせい	水火既済	名詞
ふうかかじん	風火家人	名詞
らいかほう	雷火豊	名詞
りいか	離為火	名詞
たくかかく	沢火革	名詞
たっかかく	沢火革	名詞
てんかどうじん	天火同人	名詞
ちらいふく	地雷復	名詞
さんらいい	山雷頤	名詞
すいらいちゅん	水雷屯	名詞
ふうらいえき	風雷益	名詞
しんいらい	震為雷	名詞
からいぜいごう	火雷噬嗑	名詞
たくらいずい	沢雷随	名詞
てんらいむもう	天雷无妄	名詞
ちふうしょう	地風升	名詞
さんぷうこ	山風蠱	名詞
すいふうせい	水風井	名詞
そんいふう	巽為風	名詞
らいふうこう	雷風恆	名詞
かふうてい	火風鼎	名詞
たくふうたいか	沢風大過	名詞
てんぷうこう	天風姤	名詞
ちすいし	地水師	名詞
さんすいもう	山水蒙	名詞
かんいすい	坎為水	名詞
ふうすいかん	風水渙	名詞
らいすいかい	雷水解	名詞
かすいびせい	火水未済	名詞
かすいびさい	火水未済	名詞
たくすいこん	沢水困	名詞
てんすいしょう	天水訟	名詞
ちざんけん	地山謙	名詞
ごんいざん	艮為山	名詞
ごんいさん	艮為山	名詞
すいざんけん	水山蹇	名詞
ふうざんぜん	風山漸	名詞
らいざんしょうか	雷山小過	名詞
かざんりょ	火山旅	名詞
たくざんかん	沢山咸	名詞
てんざんとん	天山遯	名詞
こんいち	坤為地	名詞
さんちはく	山地剥	名詞
すいちひ	水地比	名詞
ふうちかん	風地観	名詞
らいちよ	雷地豫	名詞
かちしん	火地晋	名詞
たくちすい	沢地萃	名詞
てんちひ	天地否	名詞
ちてんたい	☷☰	名詞
さんてんたいちく	☶☰	名詞
すいてんじゅ	☵☰	名詞
ふうてんしょうちく	☴☰	名詞
らいてんたいそう	☳☰	名詞
かてんたいゆう	☲☰	名詞
たくてんかい	☱☰	名詞
けんいてん	☰☰	名詞
ちたくりん	☷☱	名詞
さんたくそん	☶☱	名詞
すいたくせつ	☵☱	名詞
ふうたくちゅうふ	☴☱	名詞
らいたくきまい	☳☱	名詞
かたくけい	☲☱	名詞
だいたく	☱☱	名詞
てんたくり	☰☱	名詞
ちかめいい	☷☲	名詞
さんかひ	☶☲	名詞
すいかきせい	☵☲	名詞
ふうかかじん	☴☲	名詞
らいかほう	☳☲	名詞
りいか	☲☲	名詞
たくかかく	☱☲	名詞
てんかどうじん	☰☲	名詞
ちらいふく	☷☳	名詞
さんらいい	☶☳	名詞
すいらいちゅん	☵☳	名詞
ふうらいえき	☴☳	名詞
しんいらい	☳☳	名詞
からいぜいごう	☲☳	名詞
たくらいずい	☱☳	名詞
てんらいむもう	☰☳	名詞
ちふうしょう	☷☴	名詞
さんぷうこ	☶☴	名詞
すいふうせい	☵☴	名詞
そんいふう	☴☴	名詞
らいふうこう	☳☴	名詞
かふうてい	☲☴	名詞
たくふうたいか	☱☴	名詞
てんぷうこう	☰☴	名詞
ちすいし	☷☵	名詞
さんすいもう	☶☵	名詞
かんいすい	☵☵	名詞
ふうすいかん	☴☵	名詞
らいすいかい	☳☵	名詞
かすいびせい	☲☵	名詞
たくすいこん	☱☵	名詞
てんすいしょう	☰☵	名詞
ちざんけん	☷☶	名詞
ごんいざん	☶☶	名詞
すいざんけん	☵☶	名詞
ふうざんぜん	☴☶	名詞
らいざんしょうか	☳☶	名詞
かざんりょ	☲☶	名詞
たくざんかん	☱☶	名詞
てんざんとん	☰☶	名詞
こんいち	☷☷	名詞
さんちはく	☶☷	名詞
すいちひ	☵☷	名詞
ふうちかん	☴☷	名詞
らいちよ	☳☷	名詞
かちしん	☲☷	名詞
たくちすい	☱☷	名詞
てんちひ	☰☷	名詞
じゅうよく	十翼	名詞
たんでん	彖伝	名詞
たん	彖	名詞
しょうでん	象伝	名詞
たいしょう	大象	名詞
しょうしょう	小象	名詞
けいじ	繋辞	名詞
けいじでん	繋辞伝	名詞
ぶんげん	文言	名詞
ぶんげんでん	文言伝	名詞
せっか	説卦	名詞
せっかでん	説卦伝	名詞
じょか	序卦	名詞
じょかでん	序卦伝	名詞
ざっか	雑卦	名詞
ざっかでん	雑卦伝	名詞
かじ	卦辞	名詞
こうじ	爻辞	名詞
こうへん	爻変	名詞
しとく	四徳	名詞
なんけ	難卦	名詞
しか	之卦	名詞
ごか	互卦	名詞
ごたい	互体	名詞
やくしょう	約象	名詞
へんか	変卦	名詞
さっか	錯卦	名詞
そうか	綜卦	名詞
ないか	内卦	名詞
げか	外卦	名詞
じょうか	上卦	名詞
げか	下卦	名詞
さんげん	三元	名詞
さんさい	三才	名詞
たいせいか	大成卦	名詞
ごうか	合卦	名詞
ひおう	比応	名詞
ふひ	不比	名詞
おうちゅう	応中	名詞
おういち	応一	名詞
おうさん	応三	名詞
いんこう	陰爻	名詞
ようこう	陽爻	名詞
いんこう	⚋	名詞
ようこう	⚊	名詞
いん	⚋	名詞
よう	⚊	名詞
いんい	陰位	名詞
ようい	陽位	名詞
しょうよう	少陽	名詞
しょういん	少陰	名詞
ろうよう	老陽	名詞
ろういん	老陰	名詞
しょうよう	⚎	名詞
しょういん	⚍	名詞
ろうよう	⚌	名詞
ろういん	⚏	名詞
ししょう	四象	名詞
しょうしょう	小象	名詞
だいしょう	大象	名詞
しょうそくけ	消息卦	名詞
しょうそくか	消息卦	名詞
せんだん	占断	名詞
もっきょく	木局	名詞
かきょく	火局	名詞
きんきょく	金局	名詞
すいきょく	水局	名詞
さんごう	三合	名詞
きもん	奇門	名詞
とんこう	遁甲	名詞
にしょう	二生	名詞
うらなり	裏成り	名詞
かんぽう	鑑法	名詞
きっぽう	吉方	名詞
きょうほう	凶方	名詞
ごぎょう	五行	名詞
そうしょう	相性	名詞
そうこく	相剋	名詞
そうこく	相尅	名詞
こっき	剋気	名詞
こっき	尅気	名詞
しょうき	生気	名詞
たいき	退気	名詞
ひわ	毗和	名詞
すいこくか	水剋火	名詞
もくこくど	木剋土	名詞
もっこくど	木剋土	名詞
かこくきん	火剋金	名詞
どこくすい	土剋水	名詞
きんこくもく	金剋木	名詞
ごんこくもく	金剋木	名詞
もくしょうか	木生火	名詞
かしょうど	火生土	名詞
どしょうきん	土生金	名詞
きんしょうすい	金生水	名詞
すいしょうもく	水生木	名詞
じょうい	定位	名詞
こうてん	後天	名詞
せんてん	先天	名詞
ねんばん	年盤	名詞
つきばん	月盤	名詞
ひばん	日盤	名詞
こくばん	刻盤	名詞
ちゅうきゅう	中宮	名詞
かいざ	廻座	名詞サ変
ほんめい	本命	名詞
げつめい	月命	名詞
ほんめいさつ	本命殺	名詞
げつめいさつ	月命殺	名詞
はかいさつ	破壊殺	名詞
てきさつ	的殺	名詞
ごおうさつ	五黄殺	名詞
あんけんさつ	暗剣殺	名詞
あんけん	暗剣	名詞
しょうにさつ	小児殺	名詞
つきだち	月建	名詞
つきだて	月建	名詞
かんにゅう	坎入	名詞サ変
かんにゅう	陥入	名詞サ変
ようとん	陽遁	名詞
いんとん	陰遁	名詞
たいちゅう	対中	名詞サ変
たいちゅう	対冲	名詞サ変
あんじん	安心	名詞
どうかい	同会	名詞サ変
どうき	道軌	名詞
たいねんかみ	胎年加味	名詞
えほう	恵方	名詞
さいじょうほうい	最上方位	名詞
ししん	四神	名詞
げんとう	玄冬	名詞
しゅか	朱夏	名詞
はくしゅう	白秋	名詞
しょうい	象意	名詞
もとすう	元数	名詞
えいすう	盈数	名詞
ようすう	幼数	名詞
ろうすう	老数	名詞
じっかん	十干	名詞
いんし	陰支	名詞
ようし	陽支	名詞
いんかんし	陰環支	名詞
ようかんし	陽環支	名詞
りゅうねん	流年	名詞
きゅうよう	九曜	名詞
じおん	字音	名詞
じぎ	字義	名詞
てんすう	天数	名詞
ちすう	地数	名詞
ていすう	底数	名詞
てんぎょう	天行	名詞
ちぎょう	地行	名詞
ていぎょう	底行	名詞
てんかく	天格	名詞
ちかく	地格	名詞
そうかく	総格	名詞
てんちそうどうすう	天地総同数	名詞
てんちどうすう	天地同数	名詞
てんちしょうとつ	天地衝突	名詞
てんていどうすう	天底同数	名詞
しゃどうかく	斜同画	名詞
はんしゃどうかく	半斜同画	名詞
だいしゃどうかく	大斜同画	名詞
へいこうどうかく	平行同画	名詞
ちょくどうかく	直同画	名詞
ぶんりな	分離名	名詞
ろくよう	六曜	名詞
せんしょう	先勝	名詞
ともびき	友引	名詞
せんぷ	先負	名詞
ぶつめつ	仏滅	名詞
たいあん	大安	名詞
しゃっこう	赤口	名詞
なっちん	納音	名詞
かいちゅうきん	海中金	名詞
ろちゅうか	炉中火	名詞
たいりんぼく	大林木	名詞
ろぼうど	路傍土	名詞
けんぼうきん	剣鋒金	名詞
さんとうか	山頭火	名詞
かんげすい	澗下水	名詞
じょうとうど	城頭土	名詞
はくろうきん	白鑞金	名詞
ようりゅうぼく	楊柳木	名詞
せいせんすい	井泉水	名詞
おくじょうど	屋上土	名詞
へきれきか	霹靂火	名詞
しょうはくぼく	松柏木	名詞
ちょうりゅうすい	長流水	名詞
さちゅうきん	沙中金	名詞
さんげか	山下火	名詞
へいちぼく	平地木	名詞
へきじょうど	壁上土	名詞
きんぱくきん	金箔金	名詞
ふくとうか	覆燈火	名詞
てんかすい	天河水	名詞
だいえきど	大駅土	名詞
さいせんきん	釵釧金	名詞
そうたくぼく	桑柘木	名詞
たいけいすい	大溪水	名詞
さちゅうど	沙中土	名詞
てんじょうか	天上火	名詞
たくりゅうぼく	柘榴木	名詞
たいかいすい	大海水	名詞
くうぼう	空亡	名詞
こんじん	金神	名詞
きちじん	吉神	名詞
きっしん	吉神	名詞
てんどう	天道	名詞
てんとく	天徳	名詞
てんとくごう	天徳合	名詞
げっとく	月徳	名詞
げっとくごう	月徳合	名詞
しょう	生	名詞
くう	空	名詞
ないき	内気	名詞
しせい	四正	名詞
しぐう	四偶	名詞
りゅうみゃく	龍脈	名詞
りゅうもん	龍門	名詞
うんせん	運線	名詞
きもん	気門	名詞
かんきょうそう	環境相	名詞
しきちそう	敷地相	名詞
なかろうか	中廊下	名詞
なかかいだん	中階段	名詞
なかがけ	中欠け	名詞
ごおうがけ	五黄欠け	名詞
しんど	晋土	名詞
そど	楚土	名詞
りょうど	梁土	名詞
ろど	魯土	名詞
えいど	衛土	名詞
ほそう	補相	名詞
どうそう	動相	名詞
へんそう	変相	名詞
ふぎ	伏羲	人名
ふつぎ	伏羲	人名
ふぎ	包犠	人名
ふぎ	伏義	人名
ふぎ	伏儀	人名
ぶんのう	文王	人名
ぶんおう	文王	人名
こうし	孔子	人名
おうひつ	王弼	人名
ていいせん	程伊川	人名
くようだつ	孔穎達	人名
こうえいたつ	孔穎達	人名
くえいたつ	孔穎達	人名
おうようめい	王陽明	人名
ようめい	陽明	名詞
しゅし	朱子	人名
しゅき	朱熹	人名
がんかい	顔回	人名
がんえん	顔淵	人名
げんけん	原憲	人名
こうやちょう	公冶長	人名
さいが	宰我	人名
しか	子夏	人名
しこう	子貢	人名
しちょう	子張	人名
しゆう	子游	人名
しろ	子路	人名
ぜんはくぎゅう	冉伯牛	人名
ぜんゆう	冉有	人名
そうし	曾子	人名
ちゅうきゅう	仲弓	人名
もうし	孟子	人名
じゅんし	荀子	人名
ろうし	老子	人名
そうし	荘子	人名
れっし	列子	人名
そんし	孫子	人名
そんぶ	孫武	人名
そんぴん	孫臏	人名
ごし	呉子	人名
ぼくし	墨子	人名
かんぴし	韓非子	人名
